52,52,52,52,52,52,52,52,52,52,52,52,52,52,52,52,52,52,52,
52,52,52,02,30,30,30,30,30,30,30,30,30,30,02,52,52,52,52,
52,52,52,02,30,10,10,10,10,10,10,10,10,30,02,52,52,52,52,
52,52,52,02,30,30,30,30,30,30,30,30,10,30,02,52,52,52,52,
52,52,52,02,02,02,02,02,02,02,02,30,10,30,02,52,52,52,52,
52,52,52,02,02,02,02,02,02,02,02,30,10,30,02,52,52,52,52,
52,52,52,02,02,02,02,02,02,02,02,30,10,30,02,52,52,52,52,
52,52,52,02,02,02,02,02,02,02,02,30,30,30,02,52,52,52,52,
52,52,52,02,02,02,02,02,02,02,02,02,02,02,02,52,52,52,52,
52,52,52,02,02,02,02,02,02,02,02,02,02,02,02,52,52,52,52,
52,52,52,02,02,02,02,02,02,02,02,02,02,02,02,52,52,52,52,
52,52,52,02,30,30,30,30,30,30,30,30,30,30,02,52,52,52,52,
52,52,52,02,30,10,30,10,10,10,10,10,10,30,02,52,52,52,52,
52,52,52,02,30,30,30,30,30,30,30,30,30,30,02,52,52,52,52,
52,52,52,02,02,02,02,02,02,02,02,02,02,02,02,52,52,52,52,
52,52,52,02,02,02,02,02,02,02,02,02,02,02,02,52,52,52,52,
52,52,52,02,30,30,30,30,30,30,30,30,30,30,02,52,52,52,52,
52,52,52,02,30,10,10,10,10,10,10,10,10,30,02,52,52,52,52,
52,52,52,02,30,30,30,30,30,30,30,30,10,30,02,52,52,52,52,
52,52,52,02,02,02,02,02,02,02,02,30,10,30,02,52,52,52,52,
52,52,52,02,30,30,30,30,30,30,30,30,10,30,02,52,52,52,52,
52,52,52,02,30,10,10,10,10,10,10,10,10,30,02,52,52,52,52,
52,52,52,52,30,30,30,30,30,30,30,30,30,30,02,52,52,52,52,
52,52,52,52,02,02,02,02,02,02,02,02,02,02,02,52,52,52,52,
